111111111111111111111111111111111111111111111111
100000000000000100000000000000000000000000000001
10000000000000010T000T000T000T000T000T0000000001
100000000000000100000000000000000000000000000001
10000S000000000100000000000000000000000000000001
100000000000000100000000000000000000000000000001
100000000000000100000000000000000000000000000001
10000000000000000000000C000000C00000000000000001
100000000000000000000011100001111000000000000001
100000000000000100000000000000000000000000000001
100000000000000100000000000000000000000000000001
100000000000000111111111111111111111111111111111
100000000000000000000000000000000000000000000001
1000000C0000000000000000000000000000000000000001
10000000000000000000000T00000000000000T000000001
100000000000000000000000000000000000000000000001
100000000000000000000000000000000000000000000001
100000000000000000000000000000000000000000000001
100000000000000000000000000000000C00000000000001
10000000000000000000000000000000000000000000T001
100000000000000000000T00000000000000000000000001
100000000000000000000000000000000000000000000001
100000000000000000000000000000000000000000000001
100000000000000000000000000000000000000000000001
100000000000000000000000000000000000000000000001
100000T00000000000000000000000000000000000000001
100000000000000000000000000000000000000000000001
1000000000000000000000000000000T0000000000000001
100000000000000000000000000000000000000000000001
1000000000000000000000000000000000000000000C0001
100000000000000000C00000000000000000000000000001
100000000000000000000000000000000000000000000001
100000000000000000000000000000000000000000000001
100000000000000000000000000000000000000000000001
100000T0000000000000000000C000000000000000000001
100000000000000000000000000000000000000000000001
10000000000000000T000000000000000000000000000001
100000000000000000000000000000000000000000000001
111111111111111111111111111111111111111111111111