11111111111111111111111111111111111111111
100000000000000000000000000000000000T0001
10000S000000000000000C0000000000000000001
11111111110001110000000000000000000000001
100C0001110001110000000000000000000000001
10000001110001110000000000000000000000001
10000001110001110000000000000000000000001
1000000000000111000T0000000000000000C0001
10000000000001111111111111111111111111111
10000000C0000000000000000001100T000000001
10000000000000000000000000110000000000001
10000000000000000000000000011000000000001
10000000000000000000000000000000000C00001
10000000000000000000000000000000000000001
100000000T0000000000000000000000000000001
100000000000000000000000000000T0000000001
10000000000000000000000000000000000000001
10000000000000000000000000000000000000001
10000000000000000000000000000000000000001
10000000000000C0000000000000000000000C001
10000000000000000000000000000000000000001
100000000000000000000000C0000000000000001
10000000000000000000000000000000000000001
1000T000000000000000000000000000000000001
10000000000000000000000000000000000000001
11111111111111111111111111111111111111111