111111111111111111111111111111111111111
100000000000000000000000000000010000001
10000000000001100000000000100001000C001
100000000000000000000100000000010000001
1000000S0000000000000000000000010000001
100000000001110000100000000000000000001
100000000000000001100000000000000000001
100000000000000000000000000000011111001
10000100100000C000000000000000000000001
10000C000000011100000000000000000000001
100100000010000000000000001100000000001
100000100C00000000000000000000000000001
101000000000100000000000000000000100001
100000000000000000000000000011000000001
100000001000000000000000000000000000001
100000000000000000000000000C00000001001
1000000C0000000000000000000000000000001
100000000000000000000000000001000000001
100000000000000000001111000000000001001
1111111111111111111110000C0000000000001
100000000000000000000000000000000000001
100000000000000000000000000000000000001
10011110000000000000C000000000000000001
100000100000000000000000000000T00000001
100C00100000000000000000000000000000001
111111111111111111111111111111111111111