111111111111111111111111111111111
111111111111111111111111111111111
110000000000000000000000000000011
110011101000100010001001011100011
110010001100100101001010010000011
110011101010101000101100011100011
110000101001101111101010010000011
110011101000101000101001011100011
110000000000000000000000000000011
110000000000000000000000000000011
110000000000000000000000000000011
110000000000000000000000000000011
110000000000000000000000000000011
110000000000000000000000000000011
110000000000000000000000000000011
110000000000000000000000000000011
110000000000000000000000000000011
110000000000000000000000000000011
110000000000000000000000000000011
110000000000000000000000000000011
110000000000000000000000000000011
111111111111111111111111111111111
111111111111111111111111111111111