111111111111111111111111111111111
111111111111111111111111111111111
110000000000000000000000000000011
110001110100010011001001011100011
110001000110010100101010010000011
110001110101010111101100011100011
110000010100110100101010010000011
110001110100010100101001011100011
110000000000000000000000000000011
110000000000000000000000000000011
110000000000000000000000000000011
110000000000000000000000000000011
110000000000000000000000000000011
110000000000000000000000000000011
110000000000000000000000000000011
110000000000000000000000000000011
110000000000000000000000000000011
110000000000000000000000000000011
110000000000000000000000000000011
110000000000000000000000000000011
110000000000000000000000000000011
111111111111111111111111111111111
111111111111111111111111111111111