11111111111111111111111111111111
10000000000000000000000000000001
10000000000000000000000000000001
10000000000000000000000000000001
10000000000000000000000000000001
10000000000000010000000000000001
10000000000000000000000000000001
10000000000000000000000000000001
10000000000C00000000000000000001
10000000000000000000000000000001
10000000000000000000000001100001
10000000000000000000000000000001
10000000100000000000000000000001
10000000000000000000000000000001
1000000000000000S000000000000001
10000000000000000000000000C00001
10000000000000000000000000000001
10000000000000000000000000000001
10000000000000000001111000000001
100000C0000000000000000000000001
10000000000000000000000000000001
10000000000000000000000000C00001
11111111111111111111111111111111