1111111111111111111111111111111111111111
1T00000000000000000000000000000000000001
1000000000000000000000000000000000000001
1000000000000000000000000000000000000001
1000000000000000000000000000000000000001
1000000000000000000000000000000000000001
1000000000000000000000000000000000000001
1000000000000000000000000000000000000001
10000000000000C0000000000000000000000001
1000000000000000000T00000000000000000001
1000000000000000000000000000000001100001
1000000000000000000000000000000000000001
1000000010000000000000000000000000000001
1000000000000000000S00000000000000000001
1000000000000000000000000000000000000001
1000000000000000000000000000000000C00001
1000000000000000000000000000000000000001
1000000000000000000000000000000000000001
1000000000000000000000000001111000000001
100000C000000000000000000000000000000001
1000000000000000000000000000000000000001
1000000000000000000000000000000000000001
1000000000000000000000000000000000000001
1000000000000000000000000000000000000001
1000000000000000000000000000000000C000T1
1111111111111111111111111111111111111111