111111111111111111111111111111111
100000000000000000000000000000001
100000000000000000000000000000001
100000000000000000000000000000001
100000000000000000000000000000001
100000000000000000100000000000001
100000000000000000000000000000001
100000000000000000000000000000001
10000000000000C000000000000000001
100000000000000000000000000000001
100000000000000000000000001100001
1000000000000000S0000000000000001
100000001000000000000000000000001
100000000000000000000000000000001
100000000000000000000000000000001
100000000000000000000000000C00001
100000000000000000000000000000001
100000000000000000000000000000001
100000000000000000001111000000001
100000C00000000000000000000000001
100000000000000000000000000000001
100000000000000000000000000C00001
111111111111111111111111111111111